# - # # # # # # # # # # # # # # # # # # 
# - - - - - - - - - - - - - - - - - # # 
# # # # # - # # - # # - # # # - # - - #
# - # # # - # - - # # - # # - - # - # # 
# - # - - - # # # # # # # # # - # - - # 
# - - - # - - - # # - # # - # # # # # #
# - # # # # - # - - - - - - - - - - - #
# - # # - - - # # # # # # # # # # - # #
# - - - - # - - # # - - - - - - - - - #
# # # # # # # # # # # # # # # # # # - # 